%%%%%%%%%%%%%%%%%%%%%%%%%%%%%%%%%%%%%
%         %             %   %       %
%%%  %%%  %  %%%%%%%%  %  % %  %%%% %
%  %   %     %      % %  %  %  %    %
%   %  %%%%%%%   %  %   %      % %%%%
% P  %       %  %   %%%%%%%%%%%%    %
%            %   %  %  %  %     %%% %
%%%%%%%      %  %      %     %      %
%            %   %  %  %%%%%%%%% %%%%
%        %   %  %   %       %  % % .%
%   %%%%%%%%%%   %  %  %    %  % %  %
%        %   %  %   %  %       % %  %
%  %%   %        %  %  %  %%%%%% %  %
% %    %%    %  %   %  %  %    % %  %
%%    %  %   %   %  %  %  %    %    %
%%%%      %  %  %   %  %  %    %    %
%         %   %  %   % %  %    %    %
%        %%    %  %    %  %    %    %
%       %%%     %  %   %            %
%      %%%%         %  %            %
%                    % %            %
%%%%%%%%%%%%%%%%%%%%%%%%%%%%%%%%%%%%%