%%%%%%%%%%%%%%%%%%%%%%%%%%%%%%%%%%%%%
%                           .       %
%            %                      %
%            %                      %
%            %%%%%%%%               %
%            %      %               %
%            %                      %
%                   %               %
% .                 %               %
%              P    %               %
%            %      %               %
%            %      %               %
%            %      %               %
%            %      %            .  %
%%%%%% %%%%%%%      %%%%%%%%%%%%%%%%%
%          . %                      %
%            %                      %
%            %        .             %
%                                   %
%                                   %
%                                   %
%                                   %
%%%%%%%%%%%%%%%%%%%%%%%%%%%%%%%%%%%%%